Access Mode=Zugriffsrechte
Add another Path, Port, Variable, Label or Device=Weiteren Pfad, Port, Variable, Bezeichnung oder Gerät hinzufügen
Add Configuration=Konfiguration hinzufügen
Add=Hinzufügen
Additional Requirements=Zusätzliche Anforderungen
Always=Immer
App to Host=App zu Host
Application=Anwendung
apply update=Aktualisierung anwenden
Are you sure=Bist du sicher
Array must be Started to view Docker containers=Array muss **gestartet** sein, um Docker Container zu sehen
Autostart=Autostart
Back=Zurück
Backup=Sicherung
Beta=Beta
Books=Bücher
By=Von
Categories=Kategorien
Check for Updates=Nach Aktualisierungen suchen
Cloud=Cloud
Config Type=Konfigurationstyp
Configuration not found=Konfiguration nicht gefunden
Connection Type=Protokoll
Console shell command=Konsole
Container ID=Container ID
Container Path=Container-Pfad
Container Port=Container-Port
Container Size=Containergröße
Container=Container
CPU Memory load=Prozessor/Speicher Auslastung
CPU Pinning=CPU Zuweisung
Created=Erstellt
Crypto Currency=Kryptowährung
Default Value=Standardwert
Device=Gerät
Display=Anzeigen
DNS=DNS
Docker Containers=Docker-Container
Docker Hub URL=Docker-Hub-URL
Docker Service failed to start=Docker-Dienst konnte nicht gestartet werden
Downloaders=Download-Tools
Drivers=Treiber
Edit Configuration=Konfiguration bearbeiten
Exited=Beendet
Extra Parameters=Extra Parameter
Fixed IP address=Statische IP-Adresse
force update=Aktualisierung erzwingen
FTP=FTP
Game Servers=Spiele-Server
healthy=Normal
Hide Buttons=Buttons ausblenden
Hide docker allocations=Docker-Zuweisungen ausblenden
Hide more settings=Mehr Einstellungen ausblenden
Home Automation=Heimautomation
Host Path=Host-Pfad
Host Port=Host-Port
HT=HT
Icon URL=Symbol-URL
Image ID=Image-ID
Key=Schlüssel
Label=Bezeichnung
Lock sortable items=Sortierbare Elemente sperren
Management=Management
MediaApp=Medien-App
MediaServer=Medien-Server
Messenger=Messenger
Missing parameters=Fehlende Parameter
Music=Musik
Network Type=Netzwerktyp
No Docker containers installed=Keine Docker-Container installiert
None Listed=Nicht gelistet
of=von
orphan image=Verwaistes Image
Other=Andere
Overview=Beschreibung
Path=Pfad
Pause All=Alle pausieren
Photos=Fotos
Port Mappings=Port Zuordnungen
Port=Port
Post Arguments=Post-Argumente
Privileged=Privilegierte Rechte
Productivity=Produktivität
Project Page=Projektseite
Proxy=Proxy
Pulling image=Lade Image
Read Me First=Zuerst lesen
Read Only - Shared=Nur Lesen - geteilt
Read Only - Slave=Nur Lesen - sekundär
Read Only=Nur Lesen
ReadWrite - Shared=Lesen/Schreiben - geteilt
ReadWrite - Slave=Lesen/Schreiben - sekundär
rebuild ready=Bereit zur Neuerstellung
rebuilding=Wird neu erstellt
Remove template=Vorlage entfernen
Removing container=Container wird entfernt
Removing orphan image=Verwaistes Image wird entfernt
Repository=Quelle
Required=Erforderlich
Reset sorting=Sortierung zurücksetzen
Resume All=Alle fortsetzen
Save=Speichern
Select a template=Vorlage auswählen
Select categories=Kategorien auswählen
Show docker allocations=Zeige aktuelle Docker-Zuweisungen
Show more settings=Mehr Einstellungen zeigen
Stable=Stabil
Start All=Alle starten
starting up containers=Starte Container
Stop All=Alle stoppen
Stopping container=Stoppe Container
Successfully removed container=Der Container wurde erfolgreich entfernt
Successfully removed orphan image=Das verwaiste Image wurde erfolgreich entfernt
Successfully stopped container=Der Container wurde erfolgreich beendet
Support Thread=Hilfe-Forenbeitrag
Template URL=Vorlagen-URL
Template=Vorlage
The command failed=Der Befehl ist fehlgeschlagen
The command finished successfully=Der Befehl wurde erfolgreich ausgeführt
TOTAL DATA PULLED=INSGESAMT ABGERUFENE DATEN
Total size=Gesamtgröße
Unknown action=Unbekannte Aktion
Unlock sortable items=Sortierbare Elemente entsperren
Update All=Alle Aktualisieren
update ready=Bereit zum Aktualisieren
Value=Wert
Variable=Variable
Video=Video
Voip=VoIP
Volume Mappings=Volumenzuordnungen
wait=Warte
Was this container created using this plugin=Wurde dieser Container mit diesem Plugin erstellt
Web=Web
WebUI=WebUI
Writable=Beschreibbar
