A format is NEVER part of a data recovery or disk rebuild process and if done in such circumstances will normally lead to loss of all data on the disks being formatted=Eine Formatierung ist ** NIE ** Teil einer Datenwiederherstellung oder Datenträger wiederherstellung, sollte dies unter solchen Umständen geschehen gehen die Daten auf dem zu Formatierenden Laufwerk verloren
Aborted=Abgebrochen
Add=Hinzufügen
Add Pool=Pool hinzufügen
All existing data on this device will be OVERWRITTEN when array is Started=Alle vorhandenen Daten auf dem Datenträger werden ÜBERSCHRIEBEN wenn das Array gestartet wird
Array Devices=Array Datenträger
Array of %s devices=Array von %s Datenträger
Array Operation=Array Aufgaben
Attribute Name=Attributname
Attributes=Attribute
Balance Status=Balance Status
Balance=Balance
Blacklisted=Blacklisted
Boot Device=Boot Datenträger
Boot system in UEFI mode=Boote System im UEFI Modus
btrfs balance status=btrfs Balance Status
btrfs check status=btrfs Check Status
btrfs filesystem df=btrfs Dateisystem
BTRFS operation is running=BTRFS Operation läuft 
btrfs scrub status= btrfs Überprüfung Status
Can not read attributes=Attribute lesen nicht möglich
Can not read capabilities=Funktionen lesen nicht möglich
Can not read identification=Identifikation lesen nicht möglich
Canceled=Abgebrochen
Cannot contact key-server. Please check your=Key-Sever kann nicht erreicht werden. Bitte Prüfen Sie Ihre
Capabilities=Funktionen
Check Filesystem Status=Dateisystem Überprüfungsstatus
Clear Stats=Statistiken löschen
Clearing in progress=Löschen läuft
Click to spin down device=Klicken zum herunterfahren des Datenträgers
Click to spin up device=Klicken zum starten des Datenträgers
Comments=Kommentare
complete=vollständig
Completed without error=Ohne Fehler abgeschlossen
Configuration valid=Koniguration in Ordnung
Convert to raid0 mode=Zu raid0 modus konvertieren
Convert to raid1 mode=Zu raid1 modus konvertieren
Convert to raid10 mode=Zu raid10 modus konvertieren
Convert to raid5 mode see help=Zu raid5 modus konvertieren siehe Hilfe
Convert to raid6 mode see help=Zu raid6 modus konvertieren siehe Hilfe
Convert to single mode=Zu Singe modus konvertieren
Copying=Kopiere
corrected=korrigiert
Create an empty file system on the disks shown as Unmountable discarding all data currently on the disks and update parity to reflect this=Leeres Dateisystem erstellen und alle Daten löschen auf Datenträgern die als nicht Mountbar angezeigt werden und Parität aktualisieren.
Creating Flash backup=Erstelle Flash Backup
creating Flash backup zip file this may take several minutes=erstelle zip-Flash Backup Datei (dies kann einige Minuten dauern)
Creation error=Erstellungsfehler
Critical disk temperature threshold=Kritischer Datenträgertemperaturwert
Critical disk utilization threshold=Kritische Datenträgerauslastung
Current operation %s on %s=Aktuelle Aufgabe %s auf **%s**
Current position=Aktuelle Position
Custom attributes use comma to separate numbers=Benutzerdefinierte Attribute (durch Komma getrennte Zahlen)
Date of purchase=Kaufdatum
Date=Datum
Delete Pool=Lösche Pool
detected=erkannt
Device encrypted and unlocked=Datenträger verschlüsselt und entsperrt
Device encrypted=Datenträger verschlüsselt
Device is part of a pool=Datenträger ist Teil eines Pools
Device locked unknown error=Datenträger gesperrt unbekannter Fehler
Device locked wrong encryption key=Datenträger gesperrt: falscher Verschlüsselungsschlüssel
Device to be encrypted=Datenträger zu Verschlüsseln
Disk in parity slot is not biggest=Paritätsfestplatte ist nicht die größte
Disk Log Information=Datenträgerprotokoll
Do not use reserved names=Keine reservierten Namen benutzen
Do not use user share names=Keine Netzwerkfreigabenamen benutzen
Download SMART report=Download SMART Bericht
Dual parity valid requires ALL disks in their original slots=*Doppelte Parität* erfordert **ALLE** Fesplatten in den ursprünglichen Slots
Elapsed time=Verstrichene Zeit
encrypted=verschlüsselt
Encryption input=Verschlüsselungseingabe
Encryption status=Verschlüsselungsstatus
Enter new key=Neuen Schlüssel eingeben
Errors occurred - Check SMART report=Fehler - SMART Bericht Prüfen
Estimated finish=Geschätze Fertigstellung
Estimated speed=Geschätzte Geschwindigkeit
Failed=Fehlgeschlagen
Feature=Feature
File system status=Dateisystemstatus
File system type=Dateisystemtyp
Finding %s error=**%s** Fehler gefunden
Finding %s errors=**%s** Fehler gefunden
Flag=Markieren
Flash backup=Flash Backup
Flash Device Settings=Flash Datenträger Einstellungen
Format Unmountable disks=Formatiere nicht Mountbare Geräte
Formatting=Formatiere
formatting=formatiere
Free=Frei
FS=FS
Global Configuration=Globale Konfiguration
Hide=Verstecken
Identification=Identifikation
Identity=Identiät
if checked, Start array but do not mount disks=wenn ausgewählt, starte Array ohne Datenträger zu mounten
If this is a new array, move the largest disk into the parity slot=Benutze größten Datenträger als Parity wenn dies ein neues Array ist
If you are adding a new disk or replacing a disabled disk, try Parity-Swap=Falls ein neuer Datenträger hinzugefügt oder eine defekte erstzt wird bitte Parity-Swap versuchen
If you want to preserve the data on the new disks, reset the array configuration and rebuild parity instead=Falls die Daten auf dem Datenträger erhalten bleiben sollen, die Array Konfiguration zurüsetzen und die Parität neu erstellen
Information=Information
Install a replacement disk as soon as possible=Datenträger so schnell als möglich Ersetzen
Insufficient free disk space available=Nicht genug Speicherplatz vorhanden
Interrupted=Unterbrochen
Invalid configuration=Konfiguration ungültig
Invalid expansion=Ungültige Erweiterung
Invalid pool name=Ungültiger Poolname
is only available when array is Started in Maintenance mode=nur verfügbar wenn das Array im **Wartungsmodus** gestartet wird
is only available when array is Started=nur verfügbar wenn Array gestartet ist
Keyfile=Lizenz Datei
Last check completed on %s=Letzte vollständige Prüfung am **%s**
Last check incomplete on %s=Letzte nicht vollständige Prüfung am **%s**
Last checked on %s=Letzte Prüfung am **%s**
Last SMART test result=Letztes SMART Prüfergbnis
Maintenance mode=Wartungsmodus
Maintenance Mode=Wartungsmodus
Maintenance=Wartung
Manufacturing date=Herstellungsdatum
Menu View=Menüansicht
Minimum free space=Minimaler freier Speicher
Missing Cache disk=Fehlender Cache Datenträger
Missing disk=Fehlender Datenträger
Missing key=Fehlender Schlüssel
Missing=Fehlend
Mounted=gemounted
Mover is running=Mover läuft
network settings=Netzwerkeinstellungen
New data disks detected=Neue Datenfestplatte erkannt
No array data disks have been assigned=Keine Datenfestplatten dem Array zugeordnet
No data disks=Keine Datenfestplatten
No parity check history present=Kein Paritätsprüfungsverlauf vorhanden
No self-tests logged on this disk=Keine Selbsttests auf Datenträger gefunden
Not installed=Nicht installiert
Note do not use pool names which are also used as user share names=Hinweis: keine Pool Namen benutzen die auch als Netzwerkfreigabe verwendet werden
OK=OK
Once clear completes, the array may be Started, expanding the array to include the new disks=Wenn das Löschen abgeschlossen ist wird das Array gestartet und wird um den neuen Datenträger erweitert
Once copy completes, the array may be Started, to initiate Data-Rebuild of the disabled disk=Wenn das Kopieren abgeschlossen ist wird das Array gestartet und die Wiederherstellung der deaktivierten Datenträger wird gestartet
operation=Aufgrabe
Options see Help=Optionen (siehe Hilfe)
Otherwise use the keyfile method for UTF8 input=Andernfalls benutze die **keyfile** Methode für UTF8 Eingabe
Parity disks content will be overwritten=Der Inhalt von *Paritäts* Datenträgern wird überschrieben 
Parity is already valid=Parität ist bereits gültig
Parity operation is running=Paritätsaufgabe läuft
Parity valid requires ALL disks to have their original content=Für eine *gültige Parität* müssen **ALLE** Datenträger ihren ursprünglichen Inhalt haben
Parity-Check in progress=Paritätsprüfung läuft
ParityRead-Check History=Parität/Lese-Prüfungs Verlauf
Parity-SyncData-Rebuild in progress=Parität-Sync/Datenwiederherstellung läuft
Partition format=Partitionsformat
Partition size=Partitonsgröße
Passed=Bestanden
Passphrase=Verschlüsselungskennwort
Perform full balance=Vollständigen Balance ausführen
Permit UEFI boot mode=Erlaube UEFI Boot
Please check your system settings to support UEFI boot mode=Bitte Systemeinstellung Prüfen um UEFI Boot zu aktivieren
Pool Devices=Pool Datenträger
Pool name already exists=Pool name existiert bereits
Pool of %s devices=Pool aus %s Datenträgern
Preclear in progress=Preclear läuft
Printable Characters Only=Nur druckbare Zeichen
Proceed to start=Zum Start fortfahren
Raw Value=Rohwert
Raw View=Rohansicht
Read-Check in progress=Lese-Check läuft
Reboot in safe mode=Reboot im Abgesicherten Modus
registration key=Registrierungs Schlüssel
Registration Key Manager=Registrierungs Schlüssel Verwaltung
reiserfsck status=reiserfsck Status
Rename Pool=Pool umbenennen
Rename=Umbenennen
Repair corrupted blocks=Repariere Beschädigte Blöcke
Replacement disk installed=Ersatzfestplatte installiert
Replacement disk is too small=Ersatzfestplatte zu klein
Retype passphrase=Verschlüsselungspasswort erneut eingeben
Schedule=Geplant
Scrub Status=Scrub Status
Scrub=Scrub
See Cache Settings=Siehe Cache Einstellungen
self-test in progress=Selbsttest läuft
Self-Test=Selbsttest
Server boot mode=Server Boot Modus
Set default boot menu=Setze Boot Modus
show passphrase=zeige Verschlüsselungspassword
Show=Anzeigen
Slots=Slots
SMART attribute notifications=SMART Attributsbenachrichtigungen
SMART error log=SMART Fehlerprotokoll
SMART extended self-test=SMART erweiterter Selbsttest
SMART health-check failed=SMART Health-Check fehlgeschlagen
SMART notification value=SMART Benachrichtigungswert
SMART self-test history=SMART Selbsttestverlauf
SMART Settings=SMART Einstellungen
SMART short self-test=SMART kurz Selbsttest
SMART status=SMART Status
Speed=Geschwindigkeit
Spin down delay=Spin-Down Verzögerung
Spin Down=Spin-Down
Spin Up=Spin-Up
Spinup groups=Spinup Gruppen
Started, array protected=Gestartet, Array geschützt
Started, array unprotected=Gestartet, Array ungeschützt
Started, formatting=Gestartet, formatiere
Starting=Starte
Stopping=Stoppe
Sync errors=Sync-Fehler
Sync=Sync
Syslinux Configuration=Syslinux Konfiguration
Syslinux configuration=Syslinux konfiguration
Temp=Temp
The array will be immediately available, but unprotected since parity has not been assigned=Das Array ist sofort verfügbar, aber es bleibt **ungeschützt** da *Parität* nicht zugewiesen wurde
The array will be immediately available, but unprotected until Parity-Sync completes=Das Array ist sofort verfügbar, aber es bleibt **ungeschützt** bis der Paritäts-Sync fertiggestellt ist
The replacement disk must be as big or bigger than the original=Die Ersatztfestplatte muss mindestens gleich groß wie die Ursprüngliche sein
This is typically done when a new disk is added to the array to get it ready for files to be written to it=Dies geschieht normalerweise, wenn dem Array ein neuer Datenträger hinzugefügt wird, um sie für das Schreiben von Dateien vorzubereiten
This unRAID Server OS release has been withdrawn and may no longer be used. Please %s update your server=Diese unRAID Server-Version wurde zurückgezogen und kann möglicherweise nicht mehr verwendet werden. Bitte %s aktualisieren Sie den Server
This will reboot the system=Startet den Server neu
This will shutdown the system=Fährt den Server herunter
This will stop the array=Stoppt das Array
This will stop the running operation=Stoppt alle laufenden Aufgaben
Threshold=Schwelle
Title=Titel
Toggle readswrites display=Lese-/Schreibanzeige umschalten
Too many attached devices. Please consider upgrading your=Zu viele Datenträger verbunden. Bitte Lizen Upgraden
Too many wrong andor missing disks=Zu viele fehlende/falsche Datenträger
Total size=Gesamtgröße
Unassign ALL devices to delete this pool=Zuweisung **ALLER** Datenträger aufheben um diesen Pool zu löschen
unavailable no parity-check entries logged=Nicht verfügbar (keine Paritätsprüfeinträge vorhanden)
Unavailable - disk must be spun up=Nicht verfügbar - Datenträger müssen hochgefahren sein
Unavailable=Nicht verfügbar
Unclean shutdown detected=Unsauberes Herunterfahren erkannt
Unmountable disk present=Auswerfbarer Datenträger vorhanden
Unmountable disks present=Auswerfbarere Datenträger vorhanden
Unmountable Encrypted volume present=Auswerfbar: Verschlüsseltes Volumen vorhanden
Unmountable Missing encryption key=Auswerfbar: Fehlender Verschlüsselungsschlüssel
Unmountable No file system=Auswerfbar: Kein Dateisystem
Unmountable No pool uuid=Auswerfbar: Keine Pool UUID
Unmountable not btrfs pool=Auswerfbar: Kein btrfs Pool
Unmountable Volume not encrypted=Auswerfbares Volumen nicht verschlüsselt
Unmounted=Nicht bereitgestellt
Upgrading diskswapping parity=Aktualisierung Datenträger/Datenträgertausch Parität
Use ASCII characters from space to tilde=Benutze **ASCII** Zeichen von Leerzeichen bis Tilde
Use Default=Benutze Standard
Use default=Benutze standard
Use only lowercase with no special characters or leadingtrailing digits=Nur Kleinbuchstaben ohne Sonderzeichen oder führende/nachfolgende Ziffern
use printable characters only=nur druckbare Zeichen verwenden
Used=Benutzt
Value=Wert
WARNING canceling may leave the array unprotected=WARNUNG: Beim Abbrechen kann das Array ungeschützt bleiben
Warning disk temperature threshold=Warnung Datenträgertemperaturschwelle
Warning disk utilization threshold=Warnung Datenträgerauslastungsschwelle
WARNING=WARNUNG
Warranty period=Garantizeitraum
will activate a clean system power down=löst ein sauberes Herunterfahren aus
will activate a clean system reset=löst einen sauberen Neustart aus
will bring the array on-line and start Clearing new data disks=bringt das Array On-Line und startet das **Löschen** neuer Datenträger
will bring the array on-line and start Parity-Check=bringt das Array On-Line und startet die **Paritätsprüfung**
will bring the array on-line and start Parity-Sync andor Data-Rebuild=bringt das Array On-Line und startet den **Paritäts-Sync** und/oder die **Datenwiederherstellung**
will bring the array on-line=brint das Array On-Line
will copy the parity information to the new parity disk=kopiert die Paritäts Informationen auf die neue Paritätsfestplatte
will create a file system in all Unmountable disks=erstellt ein neues Dateisystem auf allen nicht Mountbaren Datenträgern
will delete the encryption keyfile=löscht den Verschlüsselungsschlüssel
will disable the missing disk and then bring the array on-line. Install a replacement disk as soon as possible=deaktiviert den fehlende Datenträger und bringt das Array On-Line. Datenträger so schnell als möglich ersetzen
will expand the file system of the data disk if possible; then bring the array on-line and start Data-Rebuild=erweitert das Dateisystem des Datenträgers wenn möglich; bringt danach das Array On-Line und startet Datenwiederherstellung
will immediately clear all disk statistics=löscht alle Datenträgerstatistiken
will immediately invoke the Mover=startet den Mover manuell
will immediately spin down all disks=fährt alle Datenträger herunter
will immediately spin up all disks=fährt alle Datenträger hoch
will pause the Clearing=pausiert Löschvorgang
will pause the Parity-Check=pasiert den Paritäts-Check
will pause the Parity-SyncData-Rebuild=pausierte Paritäts-Sync/Datenwiederherstellung
will pause the Read-Check=pausiert Read-Check
will record all disk information and bring the array on-line=speichert alle Datenträgerinformationen und brint das Array On-Line
will record all disk information, bring the array on-line, and start Parity-Sync=speichert alle Datenträgerinformationen, bringt das Array On-Line und startet Paritäts-Sync
will record the new disks information and bring the expanded array on-line=speichert alle Datenträgerinformationen und brint das Erweiterte Array On-Line
will remove the missing cache disk and then bring the array on-line=entfernt die fehlende Cache Fesplatte und bringt das Array On-Line
will resume the paused Clearing=setzt pausiertes Löschen fort
will resume the paused Parity-Check=setzt pausierte Pariätsprüfung fort
will resume the paused Parity-SyncData-Rebuild=setzt pausierte Paritäts-Sync/Datenwiederherstellung fort
will resume the paused Read-Check=setzt pausierten Read-Check fort
will start Clearing new data disks=startet **Löschvorgang** von neuen Datenträgern
will start Parity-Check=startet **Paritätsprüfung**
will start Parity-Sync andor Data-Rebuild=startet **Paritäts-Sync** und/oder **Datenwiederherstellung**
will start Read-Check of all array disks=startet **Read-Check** von allen Array Laufwerken
will start Read-Check of all data disks=startet **Read-Check** von allen Daten Laufwerken
will stop Clearing=stoppt Löschvorgang
will stop Parity-SyncData-Rebuild=Stoppt den Paritäts-Sync/Datenwiederherstellung
will stop the Parity-Check=stoppt die Paritätsprüfung
will stop the Read-Check=stoppt den Read-Check
will take the array off-line=nimt das Array Off-Line
Worst=Schlechtester
Write corrections to parity=Schreibe Paritätskorrekturen
Writes=Geschrieben
Wrong key=Falscher Schlüssel
xfs_repair status=xfs_repair Status
You may not add new disks and also remove existing disks=Keine neuen Laufwerke hinzufügen oder entfernen
your server=Ihr Server
