%s ago=vor %s
%s is out of range minimum 1 maximum 65535=%s ist ausserhalb des Bereichs (1-65535)
12 hours=12 Stunden
24 hours=24 Stunden
8023ad=802.3ad
Accumulation duration=
Accumulation frequency=
Activate=aktivieren Sie
Activated=Aktiviert
Activating=Aktivieren
Active Directory Settings=Active Directory Einstellungen
Active Directory=Active Directory
active-backup=active-backup
AD account login=AD Benutzer Login
AD account password=AD Benutzer Passwort
AD domain name=AD Domain Name
AD initial group=AD initiale Gruppe
AD initial owner=AD initialer Besitzer
AD join status=Status des AD Beitritts
AD short domain name=AD Kurz-Domainname
Add Peer=Peer hinzufügen
Add Route=Route hinzufügen
Add Tunnel=Tunnel hinzufügen
Add VLAN=VLAN hinzufügen
Advanced=Erweitert
Agent function=Dienst
Agents=Benachrichtigungs Dienste
Alerts=Alarme
Allow Remote Access=Fernzugriff zulassen
Allow=Erlauben
and, the first and last characters must be alphanumeric=und die ersten und letzten Zeichen müssen alphanumerisch sein
and=und
APC UPS Daemon user manual=APC UPS Daemon Benutzerhandbuch
APCsmart=APCsmart
Apply to activate Docker after Array is Started=Anwenden, um Docker zu aktivieren, nachdem das Array gestartet wurde
Apply to activate VMs after Array is Started=Anwenden, um VMs zu aktivieren wenn das Array gestartet wurde
Applying=Anwenden
Array must be Stopped to change=Zum Ändern muss das Array **gestoppt** sein
Array status notification=Array Statusmeldung
Array status=Array Status
Assignment error=Zuweisungsfehler
Attention=Achtung
Attribute=Attribut
Authentication method=Authentifizierungsmethode
automatic=Automatisch
Autostart=Autostart
Available notifications=Verfügbare Meldungen
Balance schedule=
balance-alb=balance-alb
balance-rr=balance-rr
balance-tlb=balance-tlb
balance-xor=balance-xor
Bar color - Text=Balken (Farbe) - Text
Bar color=Balkenfarbe
Bar gray - Text=Balken (grau) - Text
Bar gray=Balken (grau)
Basic=Einfach
Battery Charge=Akkuladung
Battery level to initiate shutdown=Akkuladung bei der heruntergefahren wird
bfq=bfq
Block group usage=
Bonding members of=Teilnehmer der Netzwerkkartenbündelung
Bonding mode=Netzwerkkartenbündelungs-Modus
Both=Beide
bottom-left=unten links
bottom-right=unten rechts
Bridging members of=Teilnehmer der Netzwerkkartenbrücke
broadcast=Broadcast
Browser=Browser
btrfs filesystem show=Btrfs Dateisystem anzeigen
btrfs scrub status=Btrfs scrub Status
btrfs vDisk=btrfs vDisk
Cache disk not enabled=Cache-Datenträger nicht aktiviert
Cache Settings=Cache-Einstellungen
Cannot provision cert that would overwrite your existing custom cert at=Es kann kein Zertifikat bereitgestellt werden, das Ihr benutzerdefiniertes Zertifikat in folgendem Pfad überschreiben würde
Cannot renew cert until within 30 days of expiry=Das Zertifikat kann erst innerhalb von 30 Tagen vor Ablauf erneuert werden
Cannot renew a custom cert at=
CA-signed certificate file=CA-signierte Zertifikats-Datei
Celsius=Celsius
center=zentrieren
Certificate expiration=Zertifikatsablauf
Certificate issuer=Zertifikatsherausgeber
Certificate subject=
Certificate will not renew unless you are signed in to Unraidnet=Certificate will not renew unless you are signed in to Unraid.net
Changes=Änderungen
Check cable=Prüfen Sie das Kabel
Check four times a day=Prüfung viermal täglich
Check once a day=tägliche Prüfung
Check once a month=monatliche Prüfung
Check once a week=wöchentliche Prüfung
Check twice a day=Prüfung zweimal täglich
Checking=Überprüfe
CIDR optional=CIDR optional
Click here to see the Unraid Wiki for more information=Klicken Sie hier, um im Unraid Wiki weitere informationen zu erhalten
Click to invoke the Mover=Klicken um Mover zu starten
Click to select PNG file=Klicken um PNG Datei auszuwählen
Click to Select=Klicken für Auswahl
Comma separated list of IPv4 and IPv6 IP addresses=Durch Komma getrennte Liste von IPv4 und IPv6 Adressen
configure your router with a static route of=Konfiguriere deinen Router auf diese statische Route
configure your router with port forwarding of port=Konfiguriere eine Portweiterleitung im Router zu Port
configuring interface=Schnittstelle wird konfiguriert
Confirm array stop command=Array beenden bestätigen
Confirm reboot powerdown commands=Neustart & Herunterfahren bestätigen
Confirm sleep command=Ruhezustand bestätigen
Confirmations=Bestätigungen
connect to any device on the VPN tunnel=Verbindung zu jedem Gerät im VPN Tunnel
connect to this server using IP address=Verbindung zu diesem Server mit der IP Adresse
Container=Container
Content=Inhalt
Correct file system errors=Korrigiere Dateisystemfehler
CPU Isolation A reboot is required to apply changes=CPU Isolation: Ein Neustart ist notwendig damit Änderungen wirksam werden
CPU isolation is prohibited while system is running in SAFE MODE=CPU Isolation ist nicht möglich, wenn das System im SAFE MODE läuft
CPU Isolation=CPU Isolation
CPU Pinning Docker=CPU Zuweisung Docker
CPU Pinning VM=CPU Zuweisung VM
CPU Pinning=CPU Zuweisung
CRAM-MD5=CRAM-MD5
Cumulative parity check=
Current date and time=Aktuelles Datum und Uhrzeit
Current usage ratio=
Custom attributes use comma to separate numbers=Benutzerdefinierte Attribute (Komma als Trennzeichen der Zahlen verwenden)
Custom banner=Benutzerdefiniertes Banner
Custom UPS cable=Benutzerdefiniertes USV Kabel
Custom=Benutzerdefiniert
custom=benutzerdefiniert
D comma G dot=D Komma : G Punkt
D comma G none=D Komma : G nichts
D comma G space=D Komma : G Leerzeichen
D dot G comma=D Punkt : G Komma
D dot G none=D Punkt : G nichts
D dot G space=D Punkt : G Leerzeichen
Daily=Täglich
Data received=Daten empfangen
Data sent=Daten gesendet
Date and Time=Datum und Uhrzeit
Date format=Datumsformat
Day of the month=Tag des Monats
Day of the week=Wochentag
Day, D Month YYYY=Tag, D Monat YYYY
Day, DD.MM.YYYY=Tag, DD.MM.YYYY
Day, DD-MM-YYYY=Tag, DD-MM-YYYY
Day, MMDDYYYY=Tag, MM/DD/YYYY
Day, Month D, YYYY=Tag, Monat D, YYYY
Day, YYYY Month D=Tag, YYYY Monat D
Day, YYYY-MM-DD=Tag, YYYY-MM-DD
DD-MM-YYYY=DD-MM-YYYY
Deactivate=Deaktivieren
Deactivating=Deaktivieren
Default appdata storage location=Standard appdata Speicherpfad
Default critical disk temperature threshold=Standardschwelle für kritische Datenträgertemperatur
Default critical disk utilization threshold=Standardschwelle für kritische Datenträgerauslastung
Default file system=Standard Dateisystem
Default ISO storage path=Standard ISO Speicherpfad
Default network bridge=Standard Netzwerkbrücke
Default partition format=Standard Partitionsformat
Default SMART attribute notifications=Standard SMART Attribut Meldungen
Default SMART controller type=Standard SMART Controller Typ
Default SMART notification tolerance level=Standard SMART Meldungsschwelle
Default SMART notification value=Standard SMART Meldungs Wert
Default spin down delay=Standard Datenträger Ruhezustandsverzögerung
Default VM storage path=Standard VM Speicherpfad
Default warning disk temperature threshold=Standardwarnschwelle für hohe Datenträgertemperatur
Default warning disk utilization threshold=Standardwarnschwelle für hohe Datenträgerauslastung
Default Windows VirtIO driver ISO=Standard Windows VirtIO Treiber ISO
Define a TLS certificate=Definieren Sie ein TLS Zertifikat
Delete directory=Lösche Verzeichnis
Delete Image File=Lösche Image Datei
Delete Peer=Peer löschen
Delete Tunnel=Tunnel löschen
Delete tunnel failed=
Delete vDisk file=Lösche vDisk Datei
Delete VLAN=Lösche VLAN
Deny=verbieten
Desired MTU=Gewünschte MTU
Detailed=Detailliert
Device=Gerät
DHCP pool=DHCP Pool
directory=Verzeichnis
Disk Settings=Datenträger Einstellungen
Display array totals=Anzeige Array Gesamt
Display device name=Anzeige der Datenträgernamen
Display position=Zeige Position
Display Settings=Anzeigeeinstellungen
Display world-wide-name in device ID=Anzeige des World-Wide-Name in der Geräte-ID
DNS Propagation is PENDING=
DNS Rebinding Protection is ENABLED=
DNS servers=DNS Server
docker containers on custom networks need static routing=Docker in eigenen Netzwerken benötigten eine statische Route
Docker custom network type=
Docker data-root=Docker data-root
Docker directory=Docker Verzeichnis
Docker LOG maximum file size=Maximale Größe der Docker-Protokolldatei
Docker LOG number of files=Anzahl der Docker-Protokolldateien
Docker LOG rotation=Rotation der Docker-Protokolldateien
Docker only=Nur Docker
Docker service=Docker Dienst
Docker Stop Timeout=Timeout für das Stoppen eines Docker Containers
Docker update notification=Hinweis auf Docker Aktualisierungen
Docker update=Docker Aktualisierung
Docker vDisk location=Docker vDisk Pfad
Docker vDisk size=Docker vDisk Größe
Docker version=Docker Version
Docker VMs=Docker + VMs
Docker volume info=Docker Volumen Informationen
Docker will be available after Array is Started=Docker wird verfügbar sein, nachdem das Array gestartet wurde
Docker=Docker
Download Windows VirtIO driver ISO=Download der Windows VirtIO Treiber ISO
Downloading=Lade herunter
Downstream=Downstream
Drag-n-drop a PNG file or click the image at the left=Drag-n-drop ein PNG-Bild oder Klick auf das Bild zur Linken
Dumb=Dumb
Duplicate port entered=Port doppelt eingegeben
Dynamix color theme=Dynamix Farbschema
eg=e.g.
Email recipients=Empfänger E-Mail-Adresse
Email subject prefix=E-Mail Betreff-Prefix
Email=E-Mail
enable advanced settings view=aktiviere erweiterte Einstellungsansicht
Enable auto start=Autostart aktivieren
Enable bonding=Netzwerkbündelung aktivieren
Enable bridging=Netzwerkbrücke aktivieren
Enable disk shares=Freigaben aktivieren
Enable Docker=Docker aktivieren
Enable NetBIOS=NetBIOS aktivieren
Enable NFS=NFS aktivieren
Enable SMB=SMB aktivieren
Enable SMB Multi Channel=
Enable spinup groups=Spin-Up HDD-Gruppen aktivieren
Enable user shares=Benutzerfreigaben aktivieren
Enable VLANs=VLANs aktivieren
Enable VMs=VMs aktivieren
Enable WSD=WSD aktivieren
encrypted=verschlüsselt
Enhanced macOS interoperability=macOS Interoperabilität aktivieren
ensure the peer network is different from=Beachte, Peer Netzwerk muss sich unterscheiden von
ensure the peer networks are different from=Beachte, Peer Netzwerke müssen sich unterscheiden von
Enter route + gateway + metric=Route, Gateway und Metrik eingeben
Ether=Ether
Ethernet Port=Netzwerkport
Event=Ereignis
Every 2 hours=Jede 2 Stunden
Every 3 hours=Jede 3 Stunden
Every 4 hours=Jede 4 Stunden
Every 6 hours=Jede 6 Stunden
Every 8 hours=Jede 8 Stunden
Every day=Jeden Tag
Every hour=Jede Stunde
Every month=Jeden Monat
Every week=Jede Woche
exceeds Disk Shutdown=überschreitet Herunterfahren von Datenträger
Excluded disks=ausgenommene Datenträger
Execution error=Fehler bei der Ausführung
Fahrenheit=Fahrenheit
Failed to open=Öffnen fehlgeschlagen
Failed to stop=Beenden fehlgeschlagen
Failure to do so may result in your docker image suffering corruption at a later time=Failure to do so may result in your docker image suffering corruption at a later time
First day=Erster Tag
First week=Erste Woche
Flash backup=Flash backup
Font size=Schriftgröße
Fourth week=vierte Woche
FTP server=FTP Server
FTP Server=
FTP users=FTP Benutzer
Full Balance recommended=
gateway name or address=Gateway Name oder IP
Gateway=Gateway
Generate Key=Schlüssel erstellen
Generate Keypair=Schlüssel-Paar erstellen
Global Share Settings=Globale Freigabeeinstellungen
Global SMART Settings=Globale SMART-Einstellungen
Header custom background color=benutzerdefinierter Header Hintergrund
Header custom meta text color=Farbe des benutzerdefinierten Metatextes in der Kopfzeile
Header custom secondary text color=
Header custom text color=benutzerdefinierte Header Textfarbe
Header menu=Header Menü
Header show description=Header Beschreibung anzeigen
HHMM=HH:MM
Hibernate VMs=VMs in den Rugezustand versetzen (hibernate)
Hide dot files=verstecke Dateien mit Punkt am Anfang (.datei)
Host access to custom networks=Host Zugang zu benutzerdefinierten Netzwerken
hosts=Hosts
Hourly=stündlich
HTML color code of 3 or 6 hexadecimal digits=HTML Farbcode (3 oder 6 hexadecimale Zeichen)
HTTP port=HTTP Port
HTTPS port=HTTPS Port
Huge=Riesig
Identification=Identifikation
Import Tunnel=Importiere Tunnel
Importance=Wichtigkeit
In most cases, this should be your public WAN IPv4 instead=In den meisten Fällen sollte dies stattdessen deine öffentliche WAN IPv4 Adresse sein
In most cases, this should be your public WAN IPv4=In den meisten Fällen sollte dies deine WAN IPv4 Adresse sein
In most cases, this should be your public WAN IPv6 instead=In den meisten Fällen sollte dies stattdessen deine öffentliche WAN IPv6 Adresse sein
In most cases, this should be your public WAN IPv6=In den meisten Fällen sollte dies deine WAN IPv6 Adresse sein
inactive=inaktiv
Included disks=beinhaltete Datenträger
Interface description=Schnittstellenbeschreibung
Interface Rules=Schnittstellenregeln
Invalid data=Ungültige Daten
Invalid email address=Ungültige E-Mail-Adresse
Invalid IPv4 gateway=Ungültiger IPv4 Gateway
Invalid IPv4 range=Ungültige IPv4 Bereich
Invalid IPv4 subnet=Ungültiges IPv4 Subnet
Invalid IPv6 gateway=Ungültiger IPv6 Gateway
Invalid IPv6 range=Ungültiger IPv6 Bereich
Invalid IPv6 subnet=Ungültiges IPv6 Subnet
Invalid pool address=Ungültiger IPv6 Adresspool
Invalid subnet size=Ungültige Subnetgröße
IP address or FQDN=IP Adresse oder FQDN
IPv4 address A.B.C.D=IPv4 Adresse (A.B.C.D)
IPv4 address assignment=IPv4 Adresszuweisung
IPv4 address=IPv4 Adresse
IPv4 custom network on interface=Benutzerdefiniertes IPv4 Netzwerk auf Schnittstelle
IPv4 default gateway=IPv4 Standard Gateway
IPv4 DNS server assignment=IPv4 DNS Server Zuweisung
IPv4 DNS server=IPv4 DNS Server
IPv4 IPv6=IPv4 IPv6
IPv4 network=IPv4 Netzwerk
IPv4 only=Nur IPv4
IPv4nn or IPv6nn route=IPv4/nn or IPv6/nn route
IPv6 address assignment=IPv6 Adresszuweisung
IPv6 address nnnnxxxxyyyy=IPv6 Adresse (nnnn:xxxx::yyyy)
IPv6 address=IPv6 Adresse
IPv6 custom network on interface=Benutzerdefiniertes IPv6 Netzwerk auf Schnittstelle
IPv6 default gateway=IPv6 Standard Gateway
IPv6 DNS server assignment=IPv6 DNS Server Zuweisung
IPv6 DNS server=IPv6 DNS Server
IPv6 network=IPv6 Netzwerk
IPv6 only=Nur IPv6
IPv6 privacy extensions=IPv6 privacy Erweiterungen
ipvlan=
is down=ist inaktiv
is not in the=ist nicht in der
Isolated CPUs=Isolierte CPUs
Isolation=Isolierung
Join=Beitreten
Key=Schlüssel
kyber=kyber
LAN hub spoke access=LAN hub & spoke access
LAN to LAN access=LAN zu LAN Zugriff
Language update notification=Hinweis zur Sprachen-Aktualisierung
Language update=Sprachen-Aktualisierung
Language=Sprache
Large=Groß
Last day=Letzer Tag
Last handshake=Letzter Handshake
Last week=Letzte Woche
LE Cert Provisioned successfully=LE Zertifikat erfolgreich bereitgestellt
Leave=Verlassen
Libvirt Log=Libvirt Log
Libvirt storage location=Libvirt Speicherpfad
Libvirt vdisk size=Libvirt vDisk Größe
Libvirt version=Libvirt Version
Libvirt volume info=Libvirt Volumen Information
License key required=Lizenzschlüssel erforderlich
List of peers=Peer-Liste
List of VLANs contains duplicate VLAN numbers=VLAN Liste enthält doppelte VLAN Nummern
Listing height=Listenhöhe
Loading=Wird geladen
Local endpoint=Lokaler Endpunkt
Local gateway uses UPnP=Lokales Gateway benutzt UPNP
Local master=Lokaler Master
Local name=Lokaler Name
Local private key=Lokaler privater Schlüssel
Local public key=Lokaler öffentlicher Schlüssel
Local server configuration=Lokale Server Konfiguration
Local server uses NAT=Lokaler Server nutzt NAT
Local syslog folder=Lokales Syslogverzeichnis
Local syslog maximum file size=Maximale Größe der lokalen Syslogdatei
Local syslog number of files=Anzahl der lokalen Syslogdateien
Local syslog port=Lokaler Syslog Port
Local syslog rotation=Rotation der lokalen Syslogdateien
Local syslog server=Lokaler Syslog-Server
Local TLD=Lokale TLD
Local tunnel address IPv6=Lokale Tunnel IPv6 Adresse
Local tunnel address=Lokale Tunnel-Adresse
Local tunnel firewall=Lokale Tunnel Firewall
Local tunnel network pool IPv6=Lokaler Tunnel Netzwerk Pool IPv6
Local tunnel network pool=Lokaler Tunnel Netzwerk Pool
Lost communication=Verbindung verloren
MAC address mismatch=Nicht übereinstimmende MAC-Adresse
MAC address=MAC Adresse
macvlan=
Mail server port=Mailserver Port
Mail server=Mailserver
Manage password=Passwort verwalten
Manage=Verwalten
Management Access=Zugangskonfiguration
mandatory=zwingend erforderlich
Manual=Anleitung
member of=Mitglied von
Metric=Metrik
Mirror syslog to flash=Syslog auf den Flash-Speicher spiegeln
Missing subnet size=Fehlende Subnetgröße
MM-DD-YYYY=MM-DD-YYYY
ModBus=ModBus
Modify with caution unable to validate path until Array is Started=Achtung, mit Bedacht verändern: Der Pfad kann erst auf Richtigkeit geprüft werden wenn das Array gestartet ist
Month of the year=Monat
Monthly=monatlich
Move now=Jetzt verschieben
Mover is running=Mover läuft
Mover logging=Mover Protokollierung
Mover schedule=Mover Zeitplan
Mover Settings=Mover Einstellungen
mq-deadline=mq-deadline
MTU size=MTU Größe
Multi-function=Multi-Funktion
Must be signed in to Unraidnet to provision cert=Must be signed in to Unraid.net to provision cert
name or ip address=Name oder IP-Adresse
Net=Netzwerk
Network protocol=Netzwerkprotokoll
Network Services=Netzwerkdienste
Network Settings=Netzwerkeinstellungen
Never check=Niemals prüfen
Never send=Niemals senden
New date and time=Neues Datum und Uhrzeit
NFS=NFS
No Balance required=
No battery detected=Kein Akku gefunden
No Cache device present=Kein Cache-Gerät vorhanden
No Cache disk present=Kein Cache-Datenträger vorhanden
No change to report=
No CPU pinning available. Docker service must be started=Keine CPU-Zuweisung (pinning) möglich. Der Docker-Dienst muss hierfür gestartet sein
No CPU pinning available. VM service must be started=Keine CPU-Zuweisung (pinning) möglich. Der KVM-Dienst muss hierfür gestartet sein
no name=Kein Name
No Parity disk present=Kein Paritätsdatenträger vorhanden
No Reply=Keine Antwort
Nominal Power=Nominale Stärke
Non-tabbed=Ohne Tabs
Not activated=Nicht aktiviert
Not allowed to assign ZERO cores=Es ist nicht erlaubt 0 Cores zuzuweisen
Not compatible with NetBIOS=Nicht mit NetBIOS kompatibel
not configured=nicht konfiguriert
Not present=Nicht vorhanden
not received=Nicht empfangen
not set=nicht definiert
Not up-to-date=Nicht auf dem neuesten Stand
not used=Nicht benutzt
Nothing to do=Nichts zu tun
Notices=Notizen
Notification Agents=Benachrichtigungs Agenten
Notification entity=Benachrichtigungs Entität
Notification Settings=Benachrichtigungs Einstellungen
Notifications display=Benachrichtigungs Anzeige
NTP server=NTP Server
Number format=Zahlenformat
Number scaling=Datengrößenformat
Obtaining DNSv4 server=speichere DNSv4 Server
Obtaining DNSv6 server=speichere DNSv6 Server
Obtaining IPv4 address=speichere IPv4 IP-Adresse
Obtaining IPv4 gateway=speichere IPv4 Gateway
Obtaining IPv6 address=speichere IPv4 IP-Adresse
Obtaining IPv6 gateway=speichere IPv6 Gateway
obtaining=speichere
On battery=Akkubetrieb
One or more paths do not exist=Ein oder mehrere Pfade existieren nicht
Online boost=Online (boost)
Online trim=Online (trim)
Online=Online
Only alphanumeric characters=Nur alphanumerische Zeichen
Only PNG images are allowed=Es sind nur PNG-Bilder erlaubt
Oops=Uuups
optional metric lowest is preferred, 0 is no default gateway=optionale Metrik (kleinste Zahl wird bevorzugt, 0 bedeutet kein Standard Gateway)
optional metric lowest is preferred=optionale Metrik (kleinste Zahl wird bevorzugt)
or=oder
Output voltage=
Page view=Seitenanzeige
Parity Check=Paritätsprüfung
Password=Passwort
Path does not exist=Pfad existiert nicht
PCIe ACS override=PCIe ACS erzwingen
PCnet=PCnet
Peer allowed IPs=erlaubte Peer IPs
Peer DNS server=Peer DNS Server
Peer endpoint=Peer Endpunkt
Peer name=Peer Name
Peer preshared key=Peer PSK
Peer private key=Peer privater Schlüssel
Peer public key=Peer öffentlicher Schlüssel
Peer tunnel address IPv6=Peer Tunnel IPv6 Adresse
Peer tunnel address=Peer Tunnel Adresse
Peer type of access=Peer Zugriffs-Typ
Peer update required=Peer Update benötigt
Persistent keepalive=Persistentes Keep-Alive
Ping=Ping
Placement of Users menu=Anzeigeort des Benutzermenüs
Please consider re-applying all configurations=Bitte ziehe eine Neukonfiguration in Betracht
Please disable the VM function=Bitte die VM Funktionalität deaktivieren
Please do this NOW=Bitte tun Sie dies JETZT
Please enter a valid gateway=Bitte ein korrektes Gateway angeben
Please enter a valid range=Bitte einen korrekten Bereich angeben
Please enter a valid sending email address=Bitte eine korrekte E-Mail-Adresse angeben
Please enter a valid subnet=Bitte ein korrektes Subnet angeben
Please note that the flash backup is not encrypted at this time=Bitte beachten Sie, dass das Flash-Backup derzeit nicht verschlüsselt ist.
Please Reboot system to make new rules active=Bitte starte das System neu, um die neuen Regeln zu aktivieren
Plugins update notification=Plugin Aktualisierungsmeldung
Plugins update=Plugin Aktualisierung
Pool address is out of range=Pool Adresse ist außerhalb des Bereichs
Pool subnet size is not defined=Pool Subnetgröße ist nicht definiert
Pool subnet size is too large=Pool Subnetgröße ist zu groß
Port %s is already in use by other services=Port %s wird bereits durch einen anderen Dienst benutzt
Port %s is duplicated=Port %s ist doppelt
Port %s is out of range minimum 1 maximum 65535=Port %s ist ausserhalb des Bereichs (1 bis 65535)
Port already in use=Port wird bereits benutzt
Port Down=Port deaktiviert
Port out of range=Port ist ausserhalb des Bereichs
Port Up=Port aktiviert
Preserve user defined networks=Speichere benutzerdefinierte Netzwerke
Preset service=Voreingestellte Dienste
Priority in header=Priorität im Header
Protocol=Protokoll
Provision=Zertifikat ausstellen
QEMU version=QEMU Version
readmodifywrite=lesen/ändern/schreiben
recommended=
reconstruct write=reconstruct write
Refreshing=Aktualisiere
Registration key required=Registrierungs-Key erforderlich
Reinitialize=Neu initialisieren
Reinitializing=Neuinitialisierung
Remark configure your router with port forwarding of port=Anmerkung: Konfigurieren Sie Ihren Router mit Portweiterleitung von Port
Remark=Anmerkung
Remote access to LAN=Fernzugriff zum LAN
Remote access to server=Fernzugriff zum Server
Remote peer configuration=Peer Remote Konfiguration
Remote syslog port=Syslog Port des entfernten Servers
Remote syslog server=Entfernter Syslog Server
Remote tunneled access=Tunnel Fernzugang
Remove Windows VirtIO driver ISO=Entferne Windows VirtIO Treiber ISO
Replied=Beantwortet
resolution=Auflösung
Restore default image=Standard-Abbild wiederherstellen
Route=Route
Routing Table=Routing Table
Rule=Regel
Rules contain duplicate MAC address assignments=Regeln beinhalten doppelte MAC-Adressen-Zuweisungen
Rules=Regeln
Runtime left to initiate shutdown=verbleibende Laufzeit bis zum Herunterfahren
Runtime Left=verbleibende Laufzeit
Samba extra configuration=Zusätzliche Samba Konfiguration
Scheduled parity check=geplante Paritätsprüfung
Scheduler=Aufgabenplanung
Scrub=Scrub
Scrub schedule=
Second week=zweite Woche
See Help for more details and workarounds=Siehe Anleitung für mehr Details
see interface=Siehe Oberfläche
Send crash information to Unraid developers=Sende Absturzinformationen an die Unraid Entwickler
Send every hour=sende jede Stunde
Send every two hours=sende alle zwei Stunden
Send four times a day=sende viermal am Tag
Send once a day=sende einmal täglich
Send once a month=sende einmal monatlich
Send once a week=sende einmal wöchentlich
Send three times a day=sende dreimal täglich
Send twice a day=sende zweimal täglich
Sending email address=Absender E-Mail-Adresse
Server hub spoke access=Server hub & spoke access
Server name=Servername
Server to server access=Server zu Server Zugriff
Server was unable to provision SSL certificate=Server konnte das SSL Zertifikat nicht bereitstellen
Set password=Setze Passwort
Setting disabled in safe mode=Einstellung deaktiviert im **safe mode**
Settings menu=Einstellungsmenü
Show array utilization indicator=Zeige Array-Benutzungs-Indikator
Show banner=Zeige Banner
Show banner background color fade=
Show Dashboard apps=Zeige Dashboard Apps
Show Peer Config=Zeige Peer Konfiguration
Shutdown time-out=Timeout beim Herunterfahren
Shutdown VMs=VMs Herunterfahren
shutdown=herunterfahren
Sign In to Unraidnet required=Sign In to Unraid.net required
Simple=Einfach
Slave=
Small=Klein
Smart=smart
SMB Extras=SMB Extras
SMB Settings=SMB Einstellungen
SMB=SMB
SMTP Settings=SMTP Einstellungen
SNMP=SNMP
Sorry, an error occurred in processing your SSL certificate=Entschuldigung, ein Fehler ist während der Ausstellung des SSL Zertifikats aufgetreten
Sorry, an error occurred updating unraidnet DNS records=Entschuldigung, ein Fehler ist während der Aktualisierung des unraidnet DNS-Eintrages aufgetreten
SSH port=SSH Port
Start APC UPS daemon=Starte APC UPS Daemon
Start page=Startseite
Static=Statisch
Stop %s to make changes, see=Beende **%s** um Änderungen durchzuführen, siehe
Stop corresponding docker containers=
Store notifications to flash=Meldungen auf Flash-Speicher speichern
Subject=Betreff
Subnet=Subnetz
subnet=Subnet
success=Erfolg
Summarized=Zusammenfassung
Syslog Server=Syslog Server
System notifications=Systemmeldungen
System Setting=Systemeinstellung
System Settings=Systemeinstellungen
Tabbed=mit Tabs
TCP=TCP
TELNET port=TELNET Port
Temperature unit=Temperatureinheit
Template Authoring Mode=Vorlagenbasierter Modus
Terminal font size=
Test running=Test läuft
Test=Test
Text - Bar color=Text - Balken (Farbe)
Text - Bar gray=Text - Balken (grau)
Text=Text
The Local endpoint does not resolve to an IPv4 address=Der lokale Endpunkt kann nicht zu einer gültigen IPv4 Adresse aufgelöst werden
The Local endpoint does not resolve to an IPv6 address=Der lokale Endpunkt kann nicht zu einer gültigen IPv6 Adresse aufgelöst werden
The Local endpoint resolves to=Der lokale Endpunkt wurde aufgelöst zu
The Local tunnel network pool cannot be in=Lokaler Tunnel Netzwerk Pool nicht erlaubt in
The Local tunnel network pool IPv6 cannot be in=Lokaler Tunnel Netzwerk Pool IPv6 nicht erlaubt in
Third week=dritte Woche
This is required to create VMs in KVM=Dies ist für die Erstellung von VMs in KVM erforderlich
this mode requires a network switch with proper setup and support=Dieser Modus erfordert einen korrekt eingerichteten Netzwerkswitch mit entsprechender Unterstützung
this must be the only peer in the tunnel and sole active tunnel when in use=dies muss der einzige Peer im Tunnel und der einzige aktive Tunnel sein wenn er verwendet wird
This removes any connections running over this tunnel=Dies entfernt jede Verbindung die über diesen Tunnel geroutet wird
This Unraid Server was unreachable from the outside=Dieser Unraid Server war von außen nicht erreichbar
Time format=Zeitformat
Time of the day=Uhrzeit
Time on battery before shutdown=Laufzeit im Akkubetrieb vor Herunterfahren
Time zone=Zeitzone
time-out=Timeout
Timestamp=Zeitstempel
TLS certificate location=Speicherort des TLS Zertifikats
to=to
Toggle keys=Schlüssel wechseln
Toggle thread to containers=Thread für Container umschalten
Toggle view=Ansicht wechseln
top-left=oben links
top-right=oben rechts
Tunable enable Direct IO=Einstellung (Direct E/A aktivieren)
Tunable enable NCQ=Einstellung aktivieren (NCQ)
Tunable fuse_remember=Einstellung (fuse_remember)
Tunable md_num_stripes=Einstellung (md_num_stripes)
Tunable md_queue_limit=Einstellung (md_queue_limit)
Tunable md_sync_limit=Einstellung (md_sync_limit)
Tunable md_write_method=Einstellung (md_write_method)
Tunable nr_requests=Einstellung (nr_requests)
Tunable poll_attributes=Einstellung (poll_attributes)
Tunable scheduler=Einstellung (Aufgabenplanung)
Tunable support Hard Links=Einstellung (Hardlink Unterstützung)
Tunnel has running containers attached=
tunnel is inactive=Tunnel ist inaktiv
Turn off UPS after shutdown=USV nach Herunterfahren ausschalten
UDP=UDP
Unable to register this Unraid Server=Dieser Unraid-Server kann nicht registriert werden
; Keep the original plugin name in settings
Unassigned Devices=Unassigned Devices
Unraid OS update notification=Unraid OS Aktualisierungsbenachrichtigung
Unraid OS update=Unraid OS Aktualisierung
Unraidnet account status=Unraid.net account status
Unraidnet Status=Unraid.net Status
Update DNS=DNS Aktualisierung
updating=aktualisiere
Updating=Aktualisiere
Upgrade Cert=
UPnP forwarding not set=UPNP: Weiterleitung ist nicht konfiguriert
UPnP state changed to=UPNP: Status gewechselt zu
UPnP tunnel is inactive=UPnP: Tunnel ist inaktiv
Upon host shutdown=Bei Herunterfahren vom Host
UPS cable=USV Anschluss
UPS Details=USV Details
UPS Load=USV Auslastung
UPS Settings=USV Einstellungen
UPS Status=USV Status
UPS type=USV Typ
USB=USB
Use image name dockerimg or docker-xfsimg or select a folder=Benutze den Image Namen docker.img oder docker-xfs.img oder wähle einen Ordner aus
Use NTP=Verwende NTP
Use only letters A-Z, digits or space,dash,underscore=Bitte nur Buchstaben(A-z), Zahlen(0-9), Bindestrich (-), Unterstrich (_) und Leerzeichen benutzen
Use SSH=Verwende SSH
Use SSLTLS=Verwende SSL/TLS
Use STARTTLS=Verwende STARTTLS
Use TELNET=Verwende TELNET
Use UPnP=Verwende UPnP
Used Free columns=Belegt / Frei Spalten
User Preferences=Benutzereinstellungen
User root=Benutzer 'root'
User shares not enabled=Benuterfreigaben nicht aktiviert
User Utilities=Benutzertools
Username=Benutzername
user-set=user-set
value must be a number=Wert muss eine Zahl sein
Value=Wert
Very large=Sehr groß
Very small=Sehr klein
VFIO allow unsafe interrupts=VFIO erlaube unsichere Interrupts
View libvirt log=Zeige das libvirt Protokoll
View Local Config=Zeige Lokale Konfiguration
View Peer Config=Zeige Peer Konfiguration
view=zeige
VLAN assignment mismatch=VLAN Zuweisung stimmt nicht überein
VLAN number=VLAN Nummer
VM Manager=VM Manager
VM manager=VM-Manager
VM Settings A reboot is required to apply changes=VM Settings: A reboot is required to apply changes
VM shutdown time-out=Timeout für das Herunterfahren einer VM
VM=VM
VMs only=nur VMs
VMs will be available after Array is Started=VMs werden nach dem Start des Array verfügbar sein
VPN Manager=VPN Manager
VPN tunnel for docker containers only=
VPN tunneled access=VPN getunnelter Zugriff
VPN tunneled access for docker=
VPN tunneled access for system=
WAN Port=WAN-Netzwerkanschluss
Warnings=Warnungen
Watts=Watt
Week of the month=Woche des Monats
Weekly=wöchentlich
WireGuard Configuration=WireGuard Konfiguration
Workgroup Settings=Arbeitsgruppeneinstellungen
Workgroup=Arbeitsgruppe
Write corrections to parity disk=Schreibe Korrekturen auf Parritätsdatenträger
WSD options experimental=experimentelle WSD Optionen
xfs vDisk=xfs vDisk
Yearly=Jährlich
You must be signed in to Unraidnet in order to generate an Unraidnet SSL certificate=You must be signed in to Unraid.net in order to generate an Unraid.net SSL certificate
Your existing Docker image file needs to be recreated due to an issue from an earlier beta of Unraid 6=Das vorhandene Docker Abbild muss aufgrund eines Problems einer frühen Beta von Unraid 6 neu erstellt werden
Your hardware does not have Intel VT-x or AMD-V capability=Die eingesetzte Hardware hat keine Intel VT-x oder AMD-V Kompatibilität
Your Lets Encrypt SSL Certificate has been provisioned and a DNS record for local IP address=Das Lets Encrypt SSL Zertifikat und ein DNS Eintrag für die lokale IP wurde bereitgestellt
Your Lets Encrypt SSL Certificate has been renewed=Das Lets Encrypt SSL Zertifikat wurde erneuert
Your local IP address %s has been updated for unraidnet=Your local IP address %s has been updated for unraid.net
Your router or DNS server has DNS rebinding protection enabled, preventing=Der Router oder der DNS-Server hat &quot;DNS rebinding protection&quot; aktiviert, dies verhindert
Your server has been registered=Ihr Server wurde registriert
Your Unraid Server is reachable from the internet=Ihr Unraid Server ist über das Internet erreichbar
YYYY-MM-DD=YYYY-MM-DD

; My Servers plugin
Are you sure you want pause communication with your remote flash backup on unraidnet=Are you sure you want pause communication with your remote flash backup on unraid.net?
Are you sure you want to erase all change history in both local and unraidnet remote=Are you sure you want to erase all change history in both local and unraid.net remote?
Disabled until you Provision an unraidnet SSL Cert and set SSL-TLS to Auto=Disabled until you Provision an unraid.net SSL Cert and set SSL-TLS to Auto
Disabled until you Provision an unraidnet SSL Cert=Disabled until you Provision an unraid.net SSL Cert
Disabled until your root user account is password-protected=
Enable Transparent 2FA for Local Access=
Enable Transparent 2FA for Remote Access=
In order to activate Flash Backup there must be at least 1GB of free space on your flash drive=In order to activate Flash Backup there must be at least 1GB of free space on your flash drive.
Local T2FA requires a myunraidnet certificate=Local T2FA requires a *.myunraid.net certificate
Local T2FA requires Unraid 610 or higher and a myunraidnet certificate=Local T2FA requires Unraid 6.10 or higher and a *.myunraid.net certificate
Local T2FA requires Unraid 610 or higher=Local T2FA requires Unraid 6.10 or higher
Local T2FA requires Use SSLTLS to be Auto and a myunraidnet certificate=Local T2FA requires Use SSL/TLS to be Auto and a *.myunraid.net certificate
Local T2FA requires Use SSLTLS to be Auto and Unraid 610 or higher=Local T2FA requires Use SSL/TLS to be Auto and Unraid 6.10 or higher
Local T2FA requires Use SSLTLS to be Auto, Unraid 610 or higher, and a myunraidnet certificate=Local T2FA requires Use SSL/TLS to be Auto, Unraid 6.10 or higher, and a *.myunraid.net certificate
Local T2FA requires Use SSLTLS to be Auto=Local T2FA requires Use SSL/TLS to be Auto
More information=More information.
port=
Remote T2FA requires a myunraidnet certificate=Remote T2FA requires a *.myunraid.net certificate
Remote T2FA requires Remote Access to be enabled and a myunraidnet certificate=Remote T2FA requires Remote Access to be enabled and a *.myunraid.net certificate
Remote T2FA requires Remote Access to be enabled and Unraid 610 or higher=Remote T2FA requires Remote Access to be enabled and Unraid 6.10 or higher
Remote T2FA requires Remote Access to be enabled, Unraid 610 or higher, and a myunraidnet certificate=Remote T2FA requires Remote Access to be enabled, Unraid 6.10 or higher, and a *.myunraid.net certificate
Remote T2FA requires Remote Access to be enabled=
Remote T2FA requires Unraid 610 or higher and a myunraidnet certificate=Remote T2FA requires Unraid 6.10 or higher and a *.myunraid.net certificate
Remote T2FA requires Unraid 610 or higher=Remote T2FA requires Unraid 6.10 or higher
The Unraid server is unreachable from outside your network Be sure you have configured your router to forward port=The Unraid server is unreachable from outside your network. Be sure you have configured your router to forward port
to the Unraid server at=
Transient errors in this log can be ignored unless you are having issues=
Unraid API extra origins=
View Flash Backup Error Log=

; Note: September 16, 2022 - 41 missing translations
