20 EHCI=2.0 (EHCI)
30 nec XHCI=3.0 (nec XHCI)
30 qemu XHCI=3.0 (qemu XHCI)
Allocation=Zuweisung
and if using graphics device passthrough it too needs UEFI=und wenn Passthrough von der Grafikkarten verwendet wird, wird ebenso UEFI benötigt
Are you sure=Sind Sie sicher?
Array must be started to view Virtual Machines=Das Array muss **gestartet** sein, um die Virtuelle Maschinen zu sehen
Autostart=Autostart
Back=Zurück
Bus=Bus
Capacity=Kapazität
Change Icon=Symbol ändern
Cleanup=Aufräumen
Click and Select cdrom image to install operating system=CD-ROM Abbild des Betriebsystems auswählen
Config Folder=Konfigurationsordner
Copy Paste Domain XML Configuration Here=Kopiere die XML Konfiguration hier her
CPU Mode=CPU Modus
CPUs=CPUs
Create=Erstelle
Creating=Erstellen
define the amount memory=Größe des anfänglichen Arbeitsspeichers definieren
define the maximum amount of memory=Größe des maximalen Arbeitsspeichers definieren
define type of cpu presented to this vm=Typ der CPUs die mit dieser VM verwendet werden definieren
description of virtual machine=Beschreibung der Virtuellen Maschine
Disk devices=Datenträger
Download Folder=Downloadordner
Download, Click and Select virtio drivers image=Image des Virtio-Treibers herunterladen, klicken und auswählen
Downloading=Herunterladen
eg=z.B.
Emulated=Emuliert
Extracting=Extrahieren
Folder to save the LibreELEC image to=Ordner in dem das LibreELEC-Abbild gespeichert wird
Folder to save the OpenELEC image to=Ordner in dem das OpenELEC-Abbild gespeichert wird
Form View=Formular Ansicht
free=frei
Graphics Card=Grafikkarte
Graphics ROM BIOS=Grafikkarten BIOS-ROM
Graphics=Grafik
Host Passthrough=Host Passthrough
Hyperv tweaks for Windows=Hyper-V Optimierungen für Windows
Hyper-V=Hyper-V
i440fx will work for most=i440fx funktionieren bei den meisten
Icon=Symbol
Initial=Anfänglicher
Invalid VM to edit=Editieren dieser VM ungültig
ISO storage path doesnt exist=Pfad zum ISO Speicherort existiert nicht
ISO storage path was empty=Pfad zum ISO Speicherort war leer
keyboard for VNC=Tastatur für VNC
LibreELEC Version=LibreELEC Version
LibreELEC=LibreELEC
Libvirt Service failed to start=Libvirt-Dienst konnte nicht gestartet werden
Logical CPUs=Logische CPUs
Machine=Gerät
Manual=Handbuch
Max=Maximaler
MD5 verification failed, your download is incomplete or corrupted=MD5-Verifikation fehlgeschlagen. Der Download ist unvollständig oder fehlerhaft
mount tag inside vm=Datenträger/Ordner innerhalb der VM
My Workstation=Mein Arbeitsplatz
name of mount tag inside vm=Name des Datenträgers/Ordners innerhalb der VM
Name of virtual machine=Name der Virtuellen Maschine
Network Bridge=Netzwerk Brücke
Network MAC=Netzwerk MAC
No Virtual Machines installed=Keine Virtuellen Maschinen installiert
None available=Keine verfügbar
Not enough free space, need at least=Nicht genügend Speicherplatz. Benötigt mindestens
Not running=Beendet
OpenELEC Version=OpenELEC Version
OpenELEC=OpenELEC
OS Install CDRom Bus=CD-ROM Bus
OS Install ISO=Betiebssystem ISO-Datei
Other PCI Devices=Andere PCI-Geräte
OVMF requires a UEFI-compatable OS=OVMF benötigt ein Betriebsystem, welches mit UEFI kompatibel ist
OVMF=OVMF
password for VNC=Passwort für VNC
path of Unraid share=Pfad der Unraid-Freigabe
path on Unraid share to save LibreELEC settings=Unraid-Freigabepfad zum speichern der Einstellungen von LibreELEC
path on Unraid share to save OpenELEC settings=Unraid-Freigabepfad zum speichern der Einstellungen von OpenELEC
Path to ROM BIOS file=Pfad zum BIOS-ROM
Please choose a folder the LibreELEC image will download to=Wählen Sie einen Ordner in dem das LibreELEC-Abbild gespeichert wird
Please choose a folder the OpenELEC image will download to=Wählen Sie einen Ordner in dem das OpenELEC-Abbild gespeichert wird
Primary=Primäre(r)
Q35 for a newer machine model with PCIE=Q35 für modernere Gerätemodelle mit PCIe
QEMU64=QEMU64
random mac, you can supply your own=Zufällige MAC-Adresse, Sie können auch eine benutzerdefinierte eingeben
re-generate random mac address=Generiere neue zufällige MAC-Adresse
Remove LibreELEC image=LibreELEC Image löschen
Remove OpenELEC image=OpenELEC Image löschen
Remove this LibreELEC file=Diese LibreELEC Datei löschen
Remove this OpenELEC file=Diese OpenELEC Datei löschen
SeaBIOS will work for most=SeaBIOS funktioniert bei den meisten
SeaBIOS=SeaBIOS
Select the BIOS=Wählen Sie das BIOS
Select the LibreELEC version to use=Version von LibreELEC auswählen
Select the machine model=Gerätemodell auswählen
Select the OpenELEC version to use=Version von OpenELEC auswählen
Select the USB Controller to emulate=Den zu emulierenden USB Controller auswählen
Separate sub-folder and image will be created based on Name=Ein Separater Unterordner und die Abbild-Datei werden basierend auf dem Namen erstellt
shares=Freigaben
Some OSes wont support USB3=Einige Betriebsysteme unterstützen USB3 nicht
Sound Card=Soundkarte
Start All=Alle starten
Start VM after creation=VM nach dem Erstellen starten
Stop All=Alle stoppen
Toggle VM autostart=VM Autostart ein-/ausschalten
type of storage image=Typ des Datenträgers
Unknown action=Unbekannte Aktion
Unknown version=Unbekannte Version
Unraid Mount tag=Bezeichnung des eingehängten Datenträgers/Ordners
Unraid Share=Unraid Freigabe
Updating=Aktualisieren
USB Controller=USB Controller
USB Devices=USB Geräte
vDisk Bus=vDisk Bus
vDisk Location=vDisk Pfad
vDisk Size=vDisk Größe
vDisk Type=vDisk Typ
vDisks=vDisks
video for VNC=Video für VNC
VirtIO Drivers CDRom Bus=VirtIO CD-ROM Bus
VirtIO Drivers ISO=VirtIO Treiber-ISO
Virtual Machines=Virtuelle Maschinen
VM creation error=Fehler beim Erstellen der VM
VM image deletion error=Fehler beim Löschen des VM-Abbilds
VNC Keyboard=VNC Tastatur
VNC Password=VNC Passwort
VNC Video Driver=VNC Grafik-Treiber
VNC=VNC
Wasnt able to stop the process=Prozess konnte nicht angehalten werden
Windows 7XP=Windows 7/XP
Windows 82012, newer Linux distros=Windows 8/2012, neuere Linux Distributionen
XML View=XML Ansicht
