; Translation Credit.  Will appear in CA's credits
translationCredit=eiselmayer, ich777 (Deutsch)
Cancel=Abbrechen

; My PSAs / banners
Happy New Year=Frohes neues Jahr
Happy Holidays from Andrew, Tracey, and family=Frohe Feiertage von Andrew, Tracey und der Familie
Please Enjoy Responsibly=Genieße, Verantwortungsvoll
Popup Blocked CA requires popups to be enabled under certain circumstances You must white list your server within your browser to allow popups=Ein Popup wurde blockiert CA braucht Popups unter bestimmten Bedingungen. Du musst Popups für deinen Server in deinem Browser erlauben.
Docker Service Not Enabled - Only Plugins Available To Be Installed Or Managed=Docker Service nicht aktiviert - Es sind nur Plugins zum Installieren oder Verwalten verfügbar
Community Applications works best when cookies are enabled in your browser Certain features may not be available=Community Applications funktioniert am besten wenn Browser Cookies aktiviert sind. Bestimmte Funktionen könnten nicht verfügbar sein.
Backup Server Active Some icons may not appear, and plugin installations may be affected=Server Backup aktiv. Einige Icons werden vielleicht nicht angezeigt und die Installation von Plugins ist eventuell beeinträchtigt.

; Sorting Options
Sorting options=Sortieroptionen
Sorting options unavailable=Sortieroptionen nicht verfügbar
Sort By Name Ascending=Aufsteigend nach Name sortieren
Sort By Name Descending=Absteigend nach Name sortieren
Sort By Downloads=Nach Downloads sortieren
Sort By Trend=Nach Trend sortieren
Sort By Date Added=Nach Hinzufügedatum sortieren
; Initial disclaimer translations
Disclaimer=Haftungsausschluss
All applications listed here are 3rd party additions to Unraid Neither the authors of Community Applications nor Limetech make any warranty as to the suitability of any application listed here=Alle hier aufgelisteten Programme für Unraid stammen von Drittanbietern, weder die Autoren der Community Applications noch Limetech übernehmen jegliche Garantie über die Angemessenheit der aufgeführten Programme
Every attempt is made to ensure that only safe and compatible applications are present=Es wird alles unternommen nur sichere und kompatible Programme anzubieten
Application Policy=Anwendungsrichtlinie
I Understand=Einverstanden
Installations of apps disabled You must accept the warning to be able to install applications=Die Installation von Apps ist deaktiviert. Bitte die Warnung akzeptieren um Programme installieren zu können
Click here=Klicke hier

; Plugin Disclaimer
Community Applications contains both docker containers and plugin applications Plugins are designed for OS enhancements, and run with full privileges on your system and are clearly identified within CA=Community Applications enthält Docker Container und Plugins. Plugins sind zur Systemverbesserungen entwickelt, werden mit allen Benutzerrechten auf dem System ausgeführt und sind klar innerhalb CA identifiziert
Plugin Note=Plugin Hinweis

; Multi Install
Install Plugin Applications=Plugin installieren

; Searches
Search=Suche
Please enter search term=Bitte Suchtext eingeben
Click Here To Get More Results From DockerHub=Klick hier um zusätzliche Ergebnisse von DockerHub zu erhalten
No Matching Applications Found On Docker Hub=Keine passenden Container auf DockerHub gefunden
No Matching Applications Found=Keine passenden Anwendungen gefunden

; Install Plugin title of openbox
Install Plugin=Plugin installieren

; Remove App from previously installed
Delete Template=Vorlage löschen
Yes, delete it=Ja, löschen

; Uninstall  popup
Uninstall Application=Anwendung deinstallieren
Yes uninstall it=Ja, deinstallieren

; Remove Private Application
Remove Private Application=Private Anwendung entfernen
Yes, remove it=Ja, entfernen

; App Pinning
Click to pin this application=Klicke um Anwendung zu makieren
Click to unpin this application=Klicke um die Makierung der Anwendung aufzuheben

; Branch installations
Choose A Branch To Install=Wähle einen Branch zum installieren

; Multiple application installs
; no apps selected
Install Selected Applications=Ausgewählte Anwendung installieren

Yes, install it=Ja, installieren

; Multi-install popup
Yes, install them=Ja, installieren
Cookies not enabled Plugins must be separately installed from docker applications=Cookies sind nicht aktiviert Plugins müssen getrennt von Docker Container installiert werden
Docker applications will be installed utilizing the most recently saved template with no user input on your part=Docker Container werden mit der aktuellsten Vorlage ohne benutzerdefinierte Eingaben installiert
Updating Support Links=Hilfe Links werden aktualisiert
Finished Installing If the DONE button did not appear, then you will need to click the red X in the top right corner=Installation abgeschlossen. Falls der FERTIG Button nicht erscheint, klicke bitte das rote X in der oberen rechten Ecke

; error messages
No data was returned It is probable that another browser session has rebooted your server Reloading this browser tab will probably fix this error=Keine Daten erhalten. Es kann sein, dass eine andere Browserinstanz den Server neu gestartet hat. Das Neuladen dieses Tabs behebt das Problem wahrscheinlich
An error occurred Could not find any %s Apps=Es ist ein Fehler aufgetreten. Es konnten keine %s Anwendungen gefunden werden.
Download of appfeed failed=Herunterladen des Appfeed fehlgeschlagen
; the %s here refers to a function being called
Something really went wrong here=Etwas ist schief gegangen
Post the ENTIRE contents of this message in the Community Applications Support Thread=Poste den GESAMTEN Inhalt dieser Nachricht in den Community Application Support Post im Forum
Unknown error happened Please post a screenshot in the support thread of the Statistics screen=Ein unbekannter Fehler ist aufgetreten. Bitte poste einen Screenshot vom Statistik Fenster in den Support Thread
Something really wrong happened Reloading the Apps tab will probably fix the problem=Etwas ist schief gegangen. Das Neuladen des App Tabs behebt das Problem wahrscheinlich
This plugin has a duplicated name from another plugin %s This will impact your ability to install both plugins simultaneously=Dieses Plugin verwendeten bereits einen Name von einem anderen Plugin %s. Dies beeinträchtigt die Installation beider Plugins gleichzeitig

; CA Sections Keep the length reasonable
MENU=MENÜ
Installed Apps=Installierte Apps
Previous Apps=Vorherige Apps
Pinned Apps=Markierte Apps
CATEGORIES=KATEGORIE
New Apps=Neue Apps
Updated Apps=Aktualisierte Apps
Random Apps=Zufällig Apps
Top New Installs=Top neue Installationen
Trending Apps=Trend-Apps
All Apps=Alle Apps
OTHER=ANDERE
Statistics=Statistiken
Credits=Credits
Support=Hilfe
VERSION=VERSION
Change Log=Changelog

; Credits
Development=Entwicklung
Additional Contributions=Zusätzliche Beteiligung
GUI Layout Design=GUI Layoutgestaltung
Application Feed=Anwendungs Feed
Additional Testing=Zusätzliche Tests
Moderation=Leitung
Additional Libraries=Zusätzliche Bibliotheken
Copyright=Copyright
Translation=Übersetzung

; Statistics page
Deprecated Applications are able to still be installed if you have previously had them installed New installations of these applications are blocked unless you enable Display Deprecated Applications within CAs General Settings=Veralterte Anwendungen können immer noch installiert werden falls du sie bereits installiert hattest. Neue Installationen diese Anwendungen sind blockiert außer du hast die Option Zeige veralterte Anwendungen in den Einstellungen von CA aktiviert
The following applications are blacklisted CA will never allow you to install or reinstall these applications=Die folgenden Anwndungen sind gesperrt. CA wird nicht mehr erlauben diese zu installieren
While highly not recommended to do, incompatible applications can be installed by enabling Display Incompatible Applications within CAs General Settings=Es ist möglich inkomaptible Anwendungen zu installieren wenn in den Einstellungen von CA Zeige nicht kompatible Anwendungen aktiviert wurde. Allerdings wird stark davon abgeraten
This display is informational ONLY=Diese Anzeige dient NUR zur Information
unknown=unbekannt
Last Change To Application Feed=Letzte änderungen im Anwendungs Feed
Number Of Docker Applications=Anzahl Docker Container
Number Of Plugin Applications=Anzahl Plugin Anwendungen
Number Of Templates=Anzahl Vorlagen
Number Of Repositories=Anzahl Repositories
Number Of Private Docker Applications=Anzahl privater Docker Container
Number Of Invalid Templates=Anzahl ungültige Vorlagen
Number Of Template Errors=Anzahl mit Fehler in Vorlagen
Number Of Blacklisted Apps=Anzahl gesperrter Anwendungen
Number Of Incompatible Applications=Anzahl inkomaptibler Anwendungen
Number Of Deprecated Applications=Anzahl veralteter Anwendungen
Number Of Moderation Entries=Anzahl der Moderationsbeiträge
Primary Server=Primärer Server
Backup Server=Backup Server

; Statistics Popup Titles
Repository List=Repository Liste
All Invalid Templates Found=Alle gefunden ungültigen Vorlagen
Template Errors=Vorlagefehler
All Moderation Entries=Alle Moderationsbeiträge

; Statistics Popup
No invalid templates found=Keine ungültigen Vorlagen gefunden
These templates are invalid and the application they are referring to is unknown=Diese Vorlagen sind ungültig und die Bezug nehmende Anwendung ist unbekannt
No templates were automatically fixed=Keine Vorlage wurde automatisch korregiert
All of these errors found have been fixed automatically=Alle Fehler wurde automatisch behoben
Note that many of these errors can be avoided by following the directions=Viele dieser Fehler können vermieden werden wenn den Vorgaben gefolgt wird
HERE=HIER
The following plugins have duplicated filenames and are not able to be installed simultaneously=Die folgenden Plugins haben doppelte Dateinamen und können daher nicht gleichzeitig installiert sein
The following docker applications refer to the same docker repository but may have subtle changes in the template to warrant this=Die folgenden Docker Anwendung verweisen auf das gleiche Docker Repository, beinhalten eventuall Änderungen die dies rechtfertigen
If any of these entries are incorrect then contact the moderators of CA to discuss=Falls einer der Einträge falsch ist, kontaktiere die Moderatoren von CA
Global Repository Comments=Globale Repository Kommentare
Applied to all applications=(Auf alle Anwendungen angewandt)
Individual Application Moderation=Individuelle Anwendungsmoderation

; Misc
Community Applications Changelog=Community Applications Changelog

; Categories try not to be excessively long This is displayed on the left of CA screen

Backup=Backup
Cloud=Cloud
Downloaders=Downloader
Game Servers=Spieleserver
Home Automation=Heimautomatisierung
Media Applications=Medienanwendungen
Books=Bücher
Music=Musik
Photos=Bilder
Video=Video
Other=Andere
Media Servers=Medienserver
Network Services=Netzwerkanwendungen
DNS=DNS
FTP=FTP
Management=Verwaltung
Messenger=Kommunikation
Proxy=Proxy
VOIP=VOIP
VPN=VPN
Web=Web
Productivity=Produktivität
Security=Sicherheit
Tools Utilities=Werkzeuge / Dienstprogramme
System=System
Themes=Themes
Utilities=Dienstprogramme
Private Apps=Private Anwendungen
Uncategorized=Ohne Kategorie

; Categories displayed within a popup or on the card
GameServers=Spieleserver
HomeAutomation=Heimautomatisierung
MediaApp=Medienanwendungen
MediaAppBooks=Medienanwendungen:Bücher
MediaAppMusic=Medienanwendungen:Musik
MediaAppPhotos=Medienanwendungen:Bilder
MediaAppVideo=Medienanwendungen:Video
MediaAppOther=Medieanwendungen:Andere
MediaServer=Medienserver
MediaServerBooks=Medienserver:Bücher
MediaServerMusic=Medienserver:Musik
MediaServerPhotos=Medienserver:Bilder
MediaServerVideo=Medienserver:Video
MediaServerOther=Medienserver:Andere
Network=Netzwerk
NetworkDNS=Netzwerk:DNS
NetworkFTP=Netzwerk:FTP
NetworkManagement=Netzwerk:Verwaltung
NetworkProxy=Netzwerk:Proxy
NetworkVOIP=Netzwerk:VOIP
NetworkVPN=Netzwerk:VPN
NetworkWeb=Netzwerk:Web
NetworkOther=Netzwerk:Andere
ToolsSystem=Werkzeuge:System
ToolsThemes=Werkzeuge:Themes
ToolsUtilities=Werkzeuge:Utilities
Other=Andere
OtherUncategorized=Andere:Ohne Kategorie
and %s more=und %s mehr

; App Popup Related
Donate To Author=Spende an AutorIn
Donate To Maintainer=Spende an BetreuerIn
Author=AutorIn
Maintainer=BetreuerIn
DockerHub=DockerHub
Application Template=Anwendungsvorlage
Base OS=Basis OS
DockerHub Stars=DockerHub Sterne
Added to CA=Hinzugefügt zu CA
Date Updated=Aktualisierungsdatum
Current Version=Aktuelle Version
Minimum OS=Mindest OS
Max OS=Maximales OS
Total Downloads=Gesamt Downloads
Licence=Lizenz
30 Day Trend=Trend 30 Tage
Ranked #%s=Platz #%s
; as in Trending up or down arrow
Trending %s=Trendgin %s
; as in As of some date
As of %s=Stand %s
This application template has been blacklisted=Diese Anwendungsvorlage wurde gesperrt
This application template has been deprecated=Diese Anwendungsvorlage ist veraltet
This application is not compatible with your version of Unraid=Diese Anwendung ist nicht kompatibel mit dieser Version von Unraid
Another browser tab or device has updated the displayed templates Some actions are not available=Ein anderer Browser Tab oder ein anderes Gerät hat die angezeige Vorlage aktualisiert. Einige Aktionen sind nicht verfügbar
Reinstall default=Neuinstallation (standard)
WebUI=WebUI
Reinstall=Neuinstallieren
Install=Intallieren
Project=Projekt
Install Using The Templates Default Tag=Instalieren mit den standard Vorgaben der Vorlage
Moderator Comments=Moderator Kommentare
Note not all authors keep up to date on change logs=Beachte, dass nicht alle Autoren das Changelog regelmäßig aktualisieren
Note not all maintainers keep up to date on change logs=Beachte, dass nicht alle Betreuer das Changelog regelmäßig aktualisieren
;the following if using a space you MUST use nbsp  but keep it down to one word if at all possible
Donate=Spende
Currently Installed Version=Aktuelle nbsp installierte nbsp Version
Install The Update=Update nbsp installieren
; as in you have the latest version already installed
Latest Version=Aktuellste Version
Multi Language Support=Mehrsprachenunterstützung
; as in more than 100000
More than %s=Mehr als %s

; Graphs
Trend Per Month=Trend pro Monat
Downloads Per Month=Downloads pro Monat
Total Downloads=Gesamte Downloads

; Multi install script
Installing docker applications %s=Docker Container %s wird installiert
Starting %s=%s startet
%s failed to start You should install it by itself to fix the errors=%s starten fehlgeschlagen. Bitte selbst installieren, um die Fehler zu beheben
Setting installed applications to autostart=Autostart der Anwendung einschalten
Docker Application Installation finished=Installation des Docker Containers abgeschlossen

; Application Cards
Private dockerHub Conversion=Private (DockerHub Konversation)
Go to the project page=Gehe zur Projektseite
Go to the support thread=Gehe zum Hilfe-Thread
Uninstall Application=Anwendung deinstallieren
Remove Private Application=Private Anwendung entfernen
Remove Application From List=Anwendung von Liste entfernen
Check off to select multiple reinstalls=Abwählen um Multiple Neuinstalltionen ausführen zu können
Go to the plugin settings=Gehe zu den Plugin Einstellungen
Click to reinstall the application using default values=Klicke um die Anwendung mit Standardvorgaben neu zu installieren
Click to edit the application values=Klicke, um die Anwendungsparameter zu ändern
Click to reinstall=Klicken zum Neuinstallieren
Click to install=Klicken zum Installieren
Install plugin=Plugin installieren
Click to go to the WebUI=Klicke um zur WebUI zu gehen
This application has been marked as being Beta=Diese Anwendung ist als Beta markiert
This application template has been deprecated=Diese Anwenungsvorlage ist veraltet
This application is not compatible with your version of Unraid=Diese Anwendung ist nicht kompatible mit dieser Version von Unraid
This application template has been blacklisted=Diese Anwendungsvorlage ist gesperrt
Search for more applications from %s=Suche mehr Anwendungen von %s
Click for more information=Klicke für mehr Informationen

; Dockerhub searches
Search For Containers From %s=Suche Container von %s
Search for similar containers=Suche ähnliche Container

; Page Navigation
Displaying %s - %s of %s=Zeige %1$s - %2$s (von %3$s)

Updating Content=Aktualisiere Inhalte
Language=Sprache
Switch to this language=Wechsle zur Sprache
Country Code=Ländercode
Install Language Pack=Sprachpaket installieren
Remove Language Pack=Sprachpaket entfernen
Update Language Pack=Sprachpaket aktualisieren
Installed Version=Installierte Version

; Help Text
This chooses how to sort the results=Diese Auswahl bestimmt die Sortierreihenfolge
These icons respectively will Install or Edit an application=Diese Icons installieren oder ändern eine Anwendung
Clicking these icons will take you to an application's GUI or settings=Klicken auf diese Icons geht zur GUI der Anwendung oder in die Einstellungen
This will update an application=Aktualisiert die Anwendung
This will take you to the appropriate support thread for an application=Geht zum Hilfe-Thread der Anwendung
This will immediately switch to the language=Ändert die Sprache sofort
This will take you to the project page for an application=Geht zur Projektseite der Anwendung
Clicking this icon will uninstall the application or delete it from the lists depending upon your current section=Klicken auf das Icon deinstalliert die Anwendung oder löscht sie je nach Auswahlt
Clicking these icons will pin or unpin an application for later viewer from the Pinned Apps section=Klicken auf diese Icons setzt oder entfernt die Anwendung von der Merkliste zur späteren Durchsicht in der Merkliste
Clicking this will display more information about the application NOTE You can also click on the applications icon to display more information=Klicke für mehr Informationen zur Anwendung. HINWEIS Klicken auf das Anwendungicon zeigt ebenfalls mehr Informationen der Anwendung
Clicking this will display any warnings or extra comments about the application=Klicken zeigt Warnungen oder weitere Kommentare zur Anwendung
On the previous apps section you can select multiple applications to install simultaneously=Im Menü Vorherige Apps können mehrer Anwendungen gleichzeitig installiert werden
This is the recommended version to install by the application author themselves=Dies ist die vom/von der AutorIn empfohlene Version zur Installation
For support for this plugin visit=Für Hilfe zu diesem Plugin gehe zu
To view the policies Community Applications has=Um die Richtlinien der Community Applications zu sehen
